111111111111
1-->S-09<--1
1-->S-08<--1
1-->S-07<--1
1-->S-06<--1
1-->S-05<--1
1-->S-04<--1
1-->S-03<--1
1-->S-02<--1
1-->S-01<--1
1-->S-00<--1
111111111111
