1111111
10000P1
10CE001
1M00001
1000C01
100E001
10000C1
10C00M1
1C0E0C1
100E001
100C001
1C00001
10E00M1
10E00C1
10W0001
1111111
