1111111
10000P1
10CE001
1E00001
1000C01
100E001
10000C1
10C0001
1C00001
1000E01
100C001
10000C1
10000E1
10000C1
100W001
1111111
