1111111
10000P1
10CE001
1E00001
1000C01
100E001
10000C1
10C00E1
1C0E0C1
100E001
100C001
10000C1
10E00E1
10E00C1
10W0001
1111111
