1111111
10000P1
10W0001
1111111
