1111111
10000P1
10E0001
1000001
1000E01
1000001
100ME01
1000E01
10C0001
1000C01
1000001
100M001
100C001
10E0E01
100M001
10W0001
1111111
