1111111
10000P1
1000001
10W0001
1111111
