1111111
10000P1
1000001
1000001
100E0C1
1000EE1
1000001
10EC001
100E0C1
1C00E01
10000E1
10W0001
1111111
