1111111
10000P1
1EEE001
1C00001
10W0001
1111111
