1111111
10000P1
10E0001
1000001
1000C01
100000
100M001
10W0001
1111111
