1111111
10000P1
1000EE1
10E0001
100E001
1000EC1
1ME00E1
10W0001
1111111
