1111111
1000P01
10E0001
1000001
1000C01
1000001
100M001
10W0001
1101111
