111111111111
1-->T-22<--1
1-->T-21<--1
1-->T-20<--1
1-->T-19<--1
1-->T-18<--1
1-->T-17<--1
1-->T-16<--1
1-->T-15<--1
1-->T-14<--1
1-->T-13<--1
1-->T-12<--1
1-->T-11<--1
1-->T-10<--1
1-->T-09<--1
1-->T-08<--1
1-->T-07<--1
1-->T-06<--1
1-->T-05<--1
1-->T-04<--1
1-->T-03<--1
1-->T-02<--1
1-->T-01<--1
1-->T-00<--1
111111111111
