1111111
10000P1
1EEEE01
10C0001
10W0001
1111111
