1111111
100W001
10E0001
1000001
1000C01
1000001
100M001
10W0001
1111111
