1111111
10000P1
1ME0C01
1E0EEE1
10W0001
1111111
