1111111
10000P1
10E0001
1000001
1000C01
1000001
100M001
10W0M01
1111111
