1111111
10000P1
10EEE01
10MC0E1
10W0001
1111111
