1111111
10000P1
10E00010101101
1000001
1111111
