1111111
10000P1
100EEE1
10000C1
10W0001
1111111
