111111111111
1-->F-09<--1
1-->F-08<--1
1-->F-07<--1
1-->F-06<--1
1-->F-05<--1
1-->F-04<--1
1-->F-03<--1
1-->F-02<--1
1-->F-01<--1
1-->F-00<--1
111111111111
