1111111
10000P1
10000E1
1E00001
10E0001
100E001
1000E01
10W0001
1111111
