1111111
10000P1
1E0EEE1
1ME0C01
10W0001
1111111
