1111111
10000P1
10000C1
1MM0MM1
1000C01
1MM0MM1
10C0001
1MM0MM1
1C00001
10W0001
1111111
