1111111
10000P1
10EE001
10ECE01
10W0001
1111111
