1111111
10000P1
10E00001
1000001
1111111
