1111111
10000P1
1EEE001
1C0E001
10W0001
1111111
